Products=Produkte
Login=Anmelden
Register=Registrieren
Submit=Abschicken
User Name=Benutzername
Password=Passwort
Save=Speichern
Logout=Abmelden
Orders=Bestellungen
Users=Benutzer
Insert Product=Produkt hinzufügen
Graphic Card=Grafikkarte
Working Memory=Arbeitsspeicher
Connections=Anschlüsse
Product Type=Produkttyp
Price=Preis
Image=Bild
Storage=Kapazität SSD
Settings=Einstellungen
Add to cart=In den Warenkorp
Delete=Löschen
Edit=Bearbeiten
Billing Address=Rechnungsadresse
Firstname=Vorname
Lastname=Nachname
Address=Adress
Street=Strasse
City=Stadt
Postal code=plz
Phonenumber=Telefonnummer
Order=Bestellen
Amount=Menge
Article Name=Artikel Name
You dont have an account=Sie haben kein Konto
register now=Jetzt registrieren
your order has been received and will be processed immediately=Ihre bestellung ist eingegangen und wird umgehend bearbeitet
